111111111111111111111111111
100000000111000011110000001
10000C00100C00000E010000011
1000P0010C0C0C0C11110000001
10000011111100C01000C000001
10000000C00100c011110C00001
111111111111111111111111111