111111111111
100010010001
1P00010C0001
1C00C00CE001
10000000C001
111111111111