111111111111111111111111111111111111111
10000000000C0000000111100C0000000000001
10000C000000C00001000100100000000000001
1000P0000C00000C0000000010C00C00C0C0011
10000000000000C00000C000100000000010001
10000000C000000000000C0010C000000100011
1000000000C0000C0000C000000000110001001
100000000000C000C000000E000000000010101
1000C0000C000000C000000000C000000C00C01
1000000000C000C0000C000000C00000C000101
100000000000000000000000000000000000001
111111111111111111111111111111111111111