1111111111111111111111111111111
10000000000C0000000000000000001
10000C000000C000000000000000001
1000P0000C00000C0000000000C00C1
10000000000000C00000C0000000001
10000000C000000000000C0000C0001
1111111111111111111111111111111